e#        
 # ###### 
 # #s   # 
 # #### # 
 #      # 
 ######## 
          
